0 0 0 0 0 0 0 0 0 0 0 0 0 0 0 0 0 0 0 0 0 0 0 0 0 0 0 0 0 0 0 0 0 0
0 0 0 0 0 0 0 0 0 0 0 0 0 0 0 0 0 0 0 0 0 0 0 0 0 0 0 0 0 0 0 0 0 0
0 0 0 0 0 0 0 0 0 0 0 0 0 0 0 0 0 0 0 0 0 0 0 0 0 0 0 0 0 0 0 0 0 0
0 0 0 0 0 3 3 3 3 3 0 0 0 0 0 0 0 0 0 0 0 0 0 0 0 3 3 3 3 3 3 0 0 0
0 3 3 3 3 0 0 0 3 3 0 0 0 0 0 0 0 0 0 0 0 0 0 0 0 3 3 0 0 3 3 0 0 0
0 3 0 0 0 0 0 0 0 0 3 3 3 0 0 0 0 0 0 0 0 0 0 0 0 0 0 0 0 0 3 3 3 3
3 3 0 0 4 0 4 0 0 0 3 3 3 3 4 0 4 0 4 0 0 0 3 3 0 0 0 0 0 0 0 0 0 3
3 3 0 0 0 0 0 0 0 0 3 3 3 3 0 0 0 0 0 0 0 0 3 3 0 0 0 0 0 0 0 0 0 3
3 3 4 0 9 9 9 9 4 0 3 3 4 0 4 0 4 0 4 0 4 0 3 3 3 0 0 0 0 0 0 0 0 3
3 3 0 0 9 9 9 9 0 0 3 3 0 0 0 0 0 0 0 0 0 0 3 3 3 3 0 0 0 0 0 0 0 3
3 3 0 0 4 0 4 0 4 0 3 3 4 0 9 9 9 9 9 9 4 0 3 3 3 3 3 3 3 0 0 0 0 3
3 3 0 0 0 0 0 0 0 0 3 3 0 0 9 9 9 9 9 9 0 0 3 3 3 3 3 3 3 0 0 0 0 3
3 3 0 0 0 0 0 0 0 0 6 0 6 0 6 0 6 0 6 0 6 0 6 0 6 0 6 0 3 0 0 0 9 9
3 3 0 0 0 0 0 0 0 0 0 0 0 0 0 0 0 0 0 0 0 0 0 0 0 0 0 0 3 3 3 3 9 9
9 9 0 0 0 0 0 0 0 0 6 0 6 0 6 0 6 0 6 0 4 0 4 0 4 0 4 0 3 3 3 3 9 9
9 9 0 0 0 3 3 3 3 3 0 0 0 0 0 0 0 0 0 0 0 0 0 0 0 0 0 0 3 0 0 0 9 9
9 9 0 0 0 3 3 3 3 3 9 9 9 9 0 0 3 3 0 0 9 9 9 9 4 0 4 0 3 0 0 0 9 9
9 9 0 0 0 0 0 3 3 3 9 9 9 9 0 0 3 3 0 0 9 9 9 9 0 0 0 0 3 0 0 0 9 9
3 3 0 0 4 0 4 0 0 0 9 9 0 0 0 0 3 3 0 0 0 0 9 9 4 0 4 0 3 0 4 0 4 0
3 3 0 0 0 0 0 0 0 0 9 9 0 0 0 0 3 3 0 0 0 0 9 9 0 0 0 0 3 0 0 0 0 0
3 3 0 0 4 0 4 0 0 0 3 3 3 3 3 3 3 3 3 3 3 3 3 3 3 3 3 3 3 0 4 0 4 0
3 3 0 0 0 0 0 0 0 0 0 0 0 0 0 0 0 0 0 0 0 0 0 0 0 0 0 0 0 0 0 0 0 0
4 0 4 0 4 0 4 0 4 0 4 0 4 0 9 9 9 9 4 0 4 0 4 0 4 0 4 0 4 0 4 0 4 0
0 0 0 0 0 0 0 0 0 0 0 0 0 0 9 9 9 9 0 0 0 0 0 0 0 0 0 0 0 0 0 0 0 0
4 0 4 0 4 0 4 0 4 0 4 0 4 0 0 0 0 0 0 0 4 0 4 0 4 0 4 0 4 0 4 0 4 0
0 0 0 0 0 0 0 0 0 0 0 0 0 0 0 0 0 0 0 0 0 0 0 0 0 0 0 0 0 0 0 0 0 0
9 9 0 0 0 3 0 0 0 0 0 0 0 0 0 0 0 0 0 0 0 0 0 0 0 0 0 0 0 0 0 0 3 3
9 9 0 0 3 3 0 0 0 0 0 0 0 0 0 3 3 3 3 0 0 0 0 0 0 0 0 0 0 0 0 0 3 3
9 9 0 3 3 3 0 0 0 0 0 0 0 0 0 3 1 0 3 0 0 0 0 0 0 0 0 0 0 0 3 3 9 9
9 9 3 3 3 3 0 0 0 0 0 0 0 0 0 3 0 0 3 0 0 0 0 0 0 0 0 0 3 3 3 3 9 9
